0 0 0 0 0 0 0 0 0 0 0 0 0 0 0 0 0 0 0 0 0 0 0 0 0 0 
1 0 0 0 0 0 0 0 0 0 0 0 0 0 0 0 0 0 0 0 0 0 0 0 0 0 
1 0 0 0 0 0 0 0 0 0 0 0 0 0 0 0 0 0 0 0 0 0 0 0 0 0 
1 0 0 0 0 0 0 0 0 0 0 0 0 0 0 0 0 0 0 0 0 0 0 0 0 0 
1 1 1 1 1 1 1 1 1 1 1 1 1 1 1 5 5 5 5 6 0 0 0 0 0 0 
1 0 0 0 0 0 0 0 0 0 2 0 3 3 3 3 3 3 4 6 1 0 0 0 0 0 
1 2 0 0 0 0 0 0 0 0 2 3 0 0 0 2 0 0 4 6 1 1 0 0 0 0 
1 2 0 0 0 0 0 0 0 0 2 0 3 0 0 0 0 0 4 6 1 1 1 0 0 0 
1 2 0 0 0 0 0 4 0 0 2 3 0 0 0 2 0 0 4 6 1 1 2 1 0 0 
1 2 4 4 4 4 4 4 4 4 2 0 3 0 0 0 0 0 4 6 1 1 2 2 1 0 
1 2 0 0 0 0 0 4 0 0 2 3 0 0 0 2 0 0 4 6 1 1 2 2 2 1 
1 2 0 0 0 0 0 4 0 0 2 0 3 0 0 0 0 0 4 6 1 1 2 2 1 0 
1 2 4 4 4 4 4 4 4 4 2 3 0 0 0 2 0 0 4 6 1 1 2 1 0 0 
1 0 0 0 0 0 0 4 0 0 2 0 3 0 0 0 0 0 4 6 1 1 1 0 0 0 
1 0 0 0 0 0 0 0 0 0 2 3 0 0 0 2 0 0 4 6 1 1 0 0 0 0 
1 0 0 0 0 0 0 0 0 0 2 0 3 3 3 3 3 3 4 6 1 0 0 0 0 0 
1 1 1 1 1 1 1 1 1 1 1 1 1 1 1 5 5 5 5 6 0 0 0 0 0 0 
1 0 0 0 0 0 0 0 0 0 0 0 0 0 0 0 0 0 0 0 0 0 0 0 0 0 
1 0 0 0 0 0 0 0 0 0 0 0 0 0 0 0 0 0 0 0 0 0 0 0 0 0 
1 0 0 0 0 0 0 0 0 0 0 0 0 0 0 0 0 0 0 0 0 0 0 0 0 0 
0 0 0 0 0 0 0 0 0 0 0 0 0 0 0 0 0 0 0 0 0 0 0 0 0 0 
